13x17
5
8,6
15,6
8,11
8,1
1,6
+++++++++++++++++
+++++##...##+++++
+++#####.#####+++
+++###+###+###+++
++##+++###+++##++
+.##+###.###+##.+
+..####...####..+
+.##+###.###+##.+
++##+++###+++##++
+++###+###+###+++
+++#####.#####+++
+++++##...##+++++
+++++++++++++++++
