13x17
5
8,6
15,6
13,10
8,1
1,6
....+++++++++....
..+++##...##+++..
..+#####.#####+..
.++###+###+###++.
++##+++###+++##++
+.##+###.###+##.+
+..####...####..+
+.##+###.###+##.+
++##+++###+++##++
.++###+###+###++.
..+#####.#####+..
..+++##...##+++..
....+++++++++....
