480
13x17
+++++++++++++++++
+++++##.p.##+++++
+++#####.#####+++
+++###+###+###+++
++##+++###+++##++
+.##+###.###+##.+
+p.####.p.####.p+
+.##+###.###+##.+
++##+++###+++##++
+++###+###+###+++
+++#####.#####+++
+++++##.p.##+++++
+++++++++++++++++
