____________________________
____________________________
____________________________
||||||||||||||||||||||||||||
|............||............|
|.||||.|||||.||.|||||.||||.|
|o||||.|||||.||.|||||.||||o|
|.||||.|||||.||.|||||.||||.|
|..........................|
|.||||.||.||||||||.||.||||.|
|.||||.||.||||||||.||.||||.|
|......||....||....||......|
||||||.|||||_||_|||||.||||||
_____|.|||||_||_|||||.|_____
_____|.||__________||.|_____
_____|.||_|||--|||_||.|_____
||||||.||_|______|_||.||||||
______.___|______|___.______
||||||.||_|______|_||.||||||
_____|.||_||||||||_||.|_____
_____|.||__________||.|_____
_____|.||_||||||||_||.|_____
||||||.||_||||||||_||.||||||
|............||............|
|.||||.|||||.||.|||||.||||.|
|.||||.|||||.||.|||||.||||.|
|o..||.......__.......||..o|
|||.||.||.||||||||.||.||.|||
|||.||.||.||||||||.||.||.|||
|......||....||....||......|
|.||||||||||.||.||||||||||.|
|.||||||||||.||.||||||||||.|
|..........................|
||||||||||||||||||||||||||||
____________________________
____________________________
