150
13x17
+++++++++++++++++
+p....+###+.#..p+
+++##...++.##.+++
+######.#.##....+
+##++.+.#.+.++#.+
+.#+.#.#++#.#+#.+
++.##.+.__#.###++
+#++#++#+++#.++#+
+##...##+..#####+
+...+.#..###+...+
+.+#..#++..##.+.+
+p+###+##.+...+p+
+++++++++++++++++

