13x17
4
1,1
15,1
1,11
15,11
+++++++++++++++++
+_....+###+.#.._+
+++##...++.##.+++
+######.#.##....+
+##++.+.#.+.++#.+
+.#+.#.#++#.#+#.+
++.##.+.__#.###++
+#++#++#+++#.++#+
+##...##+..#####+
+...+.#..###+...+
+.+#..#++..##.+.+
+_+###+##.+...+_+
+++++++++++++++++

